
SO        ./assets/textures/greystone.png



NO ./assets/textures/purplestone.png


WE ./assets/textures/mossy.png


EA ./assets/textures/eagle.png

F     180,30,234


C     30,14,49

11111111111111111111
10000000000000100001
100010000N0000000001
1001 100000000111011
10001000000000000001
10000000000000100001
11111111111111111111