
SO        ./assets/textures/so.png



NO ./assets/textures/no.png


WE ./assets/textures/we.png


EA ./assets/textures/ea.png

F     28,30,234


C     14,14,49

11111111111111111111
10000000000000100001
10S01000000000000001
1001 100000000111011
10001000000000000001
10000000000000100001
11111111111111111111