
SO        ./assets/textures/wood.png



NO ./assets/textures/eagle.png


WE ./assets/textures/colorstone.png


EA ./assets/textures/mossy.png

F     159,     200,     245


C     234    ,   14     ,49

11111111
10000001
10S01001
1001 101
10001001
10000001
11111111