
E1        ./assets/textures/wood.png



E2 ./assets/textures/eagle.png


E3 ./assets/textures/colorstone.png


E4 ./assets/textures/mossy.png

F     159,     200,     245


C     234    ,   14     ,49

11111111
10000001
10S32301
1002 201
10032301
10000001
10004001
10004001
10004001
10000001
11111111