
SO        ./assets/textures/wood.png



NO ./assets/textures/eagle.png


WE ./assets/textures/colorstone.png


EA ./assets/textures/mossy.png

F     159,     200,     245


C     234    ,   14     ,49

11111111111111111111111111111111111111111111111111111111111
10000000000000000000000000000000000000000000000000000000001
10S00000000000000000000000000000000000000000000000000000001
10000000000000000000000000000000000000000000000000000000001
10000000000000000000000000000000000000000000000000000000001
10000000000000001111111111111111111111110000000000000000001
10000000000000001000000000000000000000000000000000000000001
10000000000000001010111111111011111111110000000000000000001
10000000000000001000000000001010000000000000000000000000001
10000000000000001110100000001010000001000000000000000000001
10000000000000000010100111111011111101000000000000000000001
10000000000000000010100100000000000101000000000000000000001
10000000000000000010100000000000000001000000000000000000001
10000000000000000010100100000000000101000000000000000000001
10000000000000000010100111111011111101000000000000000000001
10000000000000000010000000000000000000000000000000000000001
10000000000000000010111111111111111111000000000000000000001
10000000000000000000000000000000000000000000000000000000001
10000000000000000000000000000000000000000000000000000000001
10000000000000000000000000000000000000000000000000000000001
10000000000000000000000000000000000000000000000000000000001
10000000000000000000000000000000000000000000000000000000001
10000000000000000000000000000000000000000000000000000000001
10000000000000000000000000000000000000000000000000000000001
11111111111111111111111111111111111111111111111111111111111