1111111111111
1001001000001
1000000000001
1000000N00001
1111111111111