11111111111111111111111111
10000000000000000020000001
10000000000030000000220001
10000022000003000030400001
10000022000000000000000001
10000000000000000030000001
12222222200000000000040001
1000200020000000003000000111111
1020002002000000000000000000001
1022222202000000000N00000000001
1000000000000000000000000000001
1111111111111111111111111111111