1111111111111
1001000000001
1000011111001
1000000S00001
1111111111111