11111111111111111111111111
10000000000000000020000001
10000000000030000000220001
10000022000003000030400001
10000022000000000000000001
10000000000000000030000001
10000000000000000000040001
10000000000000000030000001
10000000000000000000000001
1000000000000000000N000001
10000000000000000000000001
11111111111111111111111111