     11111111111111111111111111
     10000000000000000020000001
     10000000000030000000220001
     10000022000003000030400001
1111110000022000000000000111111
10000000000000000030000001     
12222222200000000000040001     
1000200020000000000000000111111
1020002002000001110000000000001
1022222202000001 10N00000000001
1000000000000001 10000000000001
1111111111111111 11111111111111